11111111111111111111111
1110000C000000C00000C01
1P000C0001110000X000001
111000C0000C00000000001
1111111111111111110C111
111111111111111111C0001
10000000000000110000001
100X0011000C00001100X01
1C0000C0000110000000001
1X0C1111111111111111111
100000000X00000000C0001
11100001111000CCCCCCXE1
1C0X000C0000000000C0001
11111111111111111111111