11111111111
10000000001
10000000001
10000000001
10000000001
10000000001
10000000001
10000000001
10000000001
1P0CCC0C0E1
11111111111